####################
....................
....................
....................
....................
....................
....................
.........GGG........
.........###........
....................
..............GGG...
....................
....................
.1#..M..M...M.M..#X.
####################
