....................
..................P.
..................#.
....................
....................
....................
....................
..........P.........
.........###........
....................
.....G..............
....###.......###...
....................
.P................X.
####..##############