....................
....................
....................
....................
....................
....................
....................
.........GGG........
.........###........
....................
..............GGG...
....................
....M...............
.1................X.
####################
