####################
....................
....................
....................
L...................
L.................X.
L..~~~HHH........###
L...................
L...................
L...................
L...................
L...................
L1.VVV..............
####################
