....................
....................
....................
....................
....................
....................
....................
....#....GGG........
....#....###........
....#...............
....#..M......GGG...
....#...............
.............M......
.1..M.#..M.#......X.
####################
