####################
....................
....................
....................
....................
..................X.
...~~~HHH........###
....................
....................
....................
....................
....................
.1.VVV..............
####################
